R 1920 1080
NO ./textures/wall/Wall_1.xpm
SO ./textures/wall/Wall_2.xpm
WE ./textures/wall/Wall_3.xpm
EA ./textures/wall/Wall_4.xpm
ST ./textures/wall/Wall_mossy.xpm
FT ./textures/wall/Wall_tile.xpm
OI1 ./textures/object/Object_barrel.xpm
OP1 ./textures/object/Object_Green_Light.xpm
OP2 ./textures/object/Object_Blue_Light.xpm
OP3 ./textures/object/Object_Red_Light.xpm
OC1 ./textures/object/Object_star.xpm
F 184,113,39
C 51,198,227
ES 0.05
EH 3
MS 0.05
RS 0.05

1 1 1 1 1 1 1 1 1 1 1 1 1 1 1 1 1 1 1 1 1
1 0 0 0 0 0 0 0 0 0 0 0 0 0 0 0 0 0 0 0 1
1 0 0 0 0 0 0 0 0 0 f 0 0 0 0 0 0 0 0 0 1
1 0 0 S 0 0 0 0 0 0 0 0 0 0 0 0 0 S 0 0 1
1 0 0 0 0 0 0 0 0 0 0 0 0 0 0 0 0 0 0 0 1
1 0 0 0 0 0 0 0 0 0 f 0 0 0 0 0 0 0 0 0 1
1 0 0 0 0 0 0 0 0 0 0 0 0 0 0 0 0 0 0 0 1
1 0 0 0 0 0 0 0 0 0 0 0 0 0 0 0 0 0 0 0 1
1 0 0 0 0 0 0 0 0 0 f 0 0 0 0 0 0 0 0 0 1
1 0 0 0 0 0 0 0 0 0 0 0 0 0 0 0 0 0 0 0 1
1 0 0 0 0 E 0 0 0 0 f 0 0 0 0 W 0 0 0 0 1
1 0 0 0 0 0 0 0 0 0 0 0 0 0 0 0 0 0 0 0 1
1 0 0 0 0 0 0 0 0 0 0 0 0 0 0 0 0 0 0 0 1
1 0 0 0 0 0 0 0 0 0 f 0 0 0 0 0 0 0 0 0 1
1 0 0 0 0 0 0 0 0 0 0 0 0 0 0 0 0 0 0 0 1
1 0 0 0 0 0 0 0 0 0 0 0 0 0 0 0 0 0 0 0 1
1 0 0 0 0 0 0 0 0 0 f 0 0 0 0 0 0 0 0 0 1
1 0 0 N 0 0 0 0 0 0 0 0 0 0 0 0 0 N 0 0 1
1 0 0 0 0 0 0 0 0 0 0 0 0 0 0 0 0 0 0 0 1
1 0 0 0 0 0 0 0 0 0 f 0 0 0 0 0 0 0 0 0 1
1 1 1 1 1 1 1 1 1 1 1 1 1 1 1 1 1 1 1 1 1